ID_1,ID_2,ID_3,ID_4,ID_5,ID_6,ID_7,ID_8,ID_9,ID_10,ID_11,ID_12
60,58,93,87,80,104,91,143,114,125,109,68
20,19,22,17,27,35,69,20,36,49,51,13
22,7,44,18,34,32,24,29,37,43,67,19
19,13,24,31,12,42,32,40,33,37,51,13
13,15,21,34,26,28,21,0,30,35,46,13
30,21,60,47,42,58,46,42,62,45,64,14
24,23,36,59,28,46,52,28,51,48,47,21
56,32,63,56,60,51,41,48,45,72,40,24
88,54,53,39,49,61,42,39,68,28,31,24
235,308,151,173,209,107,143,161,89,84,62,330
